{
    "0": "------------------------------------------------------------------------------------------------------GCAACAGCTCAAATTTGAAATCTGGCGC-----AAGCCCGAGTTGTAATTTGTAGAGGATGCTTCTGGGCAGC-GGCC-GGTCTAAGTTCCTTGGAACAGGACGTCATAGAGGGTGAGAATCCCGTATGCGACCGG--CTGGCACCCT-CCACGTAGCTCCTTCGACGAGTCGAGTTGTTTGGGAATGCAGCTCTAAATGGGAGGTAAATTTCTTCTAAAGCTAAATACCGGCCAGAGACCGATAGCGCACAAGTAGAGTGATCGAAAGATGAAAAGCACTTTGGAAAGAGAGTTAAAAAGCACGTGAAATTGTTGAAAGGGAAGCGCTTGCAACCAGACTTGT-TAGCGGTGTTCCGCCGGTCTTCT-GACC-GGTCCAC-TCACCGT-TCGCAGGCCAGCATCGTCTGGGC-CCGCCGGATAAAGACGCGAGGAATGTGGCTCC-CTTC---GGGGAGTGTTATAGCCACGCGTGCAATACGGCGTGACCCGGGCGAGGTCCGCGCTTCGGCTAGGATGCTGGCGTAATGGTCGTAAGCGG-CCCGTCTTGAAACACGGACCAAGGAGTCTACTATCTATGCGAGTGTTCGGGTGTCAAACCCTT-GCGCGTAATGAAAGTGAACGGAGG-CGAG-AACT-------AC--GG-TGCATCGTCGACCGATCCTGATGTC--TTCGGATGGATTTGAGTAAGAGCATAGCTAGTGGGACCCG-AAAGATGGTGAACTATG-CCTGAATA-GGGTGAAGCCAGAGGAAA-CT-CT-GGTGGAGGCTCGCAGCGG-TTCTGACGTGC-AAATC-GATCGTC-AAATTTGGGTATAGGGGCGAAAGACTAAT-CGAACC----------------------------------------------------------------------------------------------------------------------------------------------------------------------------------------------------------------------------------------------------------------------------------------------------------------------------",
    "1": "----------------------------------------------------CGGAGGAAAAGAAACCAACAGGGATTGCCCTAGTAACGGCGAGTGAAGCGGCAAGAGCTCAGATTTGAAATCTGGCGCCTTCGGCGTCCGAGTTGTAATCTGTAGAGGATGCTATTGGGTAGC-CACC-GGTCTAAGTCCCCTGGAACGGGGCGTCGCAGAGGGTGAGAATCCCGTATGTGACCGG-AAGGGCGCCCT-CCACATAGCTCCTTCGACGAGTCGAGTTGTTTGGGAATGCAGCTCTAAATGGGAGGTAAATTCCTTCTAAAGCTAAATATTGGCCAGAGACCGATAGCGCACAAGTAGAGTGATCGAAAGATGAAAAGCACTTTGGAAAGAGAGTTAAAAAGCACGTGAAATTGTTGAAAGGGAAGCGCTTGCAACCAGACTTGT-TGGCGGTGTTCCGCCGGTCTTCT-GACC-GGTGTAC-TCGCCGT-CTGCAGGCCAGCATCATCTGGGG-CCGCCGGATAAAAGCTTGGGGAATGTGGCTCC--TTC----GGGAGTGTTATAGCCCCTCGTGCAATACGGCGTGCCTCGGGTGAGGTCCGCGCTTCGGCTAGGATGCTGGCGTAATGGTCGTAAGCGG-CCCGTCTTGAAACACGGACCAAGGAGTCTAACATCTATGCGAGTGTTCGGGTGCCAAACCCCT-ACGCGTAATGAAAGTGAACGGAGG-TGGG-AGCC-------TTAGGG-TGCACCATCGACCGATCCTGATGTC--TTCGGATGGATTTGAGTAAGAGCATAGCTGTTGGGACCCG-AAAGATGGTGAACTATG-CCTGGATA-GGGTGAAGCCAGAGGAAA-CT-CT-GGTGGAGGCTCGCAGCGG-TTCTGACGTGC-AAATC-GATCGTC-AAATTTGGGTATAGGGGCGAAAGACTAAT-CGAACCAT--------------------------------------------------------------------------------------------------------------------------------------------------------------------------------------------------------------------------------------------------------------------------------------------------------------------------",
    "2": "----------------------------------------------------------------------CAGGGATTGCCCTAGTAACGGCGAGTGAAGCGGCAACAGCTCAAATTTGAAATCTGGCGC-----AAGCCCGAGTTGTAATTTGTAGAGGATGCTTCTGGGCAGC-GGCC-GGTCTAAGTTCCTTGGAACAGGACGTCACAGAGGGTGAGAATCCCGTATGTGATCGG--TTGGCACCCG-CTACGTAGCTCCTTCGACGAGTCGAGTTGTTTGGGAATGCAGCTCTAAATGGGAGGTAAATGCCTTCTAAAGCTAAATACCGGCCAGAGACCGATAGCGCACAAGTAGAGTGATCGAAAGATGAAAAGCACTTTGGAAAGAGAGTTAAAAAGCACGTGAAATTGTTGAAAGGGAAGCGCATGCAACCAGACTTGT-CCGCGGTGTTCCGCCGGTCTTCT-GACC-GGTCTAC-TCGCCGC-GGGCAGGCCAGCATCATCTGGGA-GCGCCGGATAAAGGTAGCGGGAATGTGGCCCC---TC-----GGGGTGTTATAGCTCGCTACACAATACGGCGCCTCCCGGGTGAGGTCCGCGCTTCGGCTAGGATGCTGGCGTAATGGTTGTATGC-G-CCCGTCTTGAAACACGGACCAAGGA-TCTACCATCTATGC-AGTGTTCGGGTGTCAA--CCCT-AC-CGCAAT--AAGTGAACG-AGG-T-GG-AACC--------C-AGG-TGCACCATC-ACCGATCCTGA-GTC--TT--GATGGA-TT-A-TAA-AGCATAGCTGGTGGGACCCG-AAAGATGGTGAACTATG-CCTGAATA-GGGTGAAGCCAGAGGAAA-CT-CT-GGTGGAGGCTCGCAGCGG-TTCTGACGTGC-AAATC-GATCGTC-AAATTTGGGTATAGGGGCGAAAGACTAAT-CGAACC----------------------------------------------------------------------------------------------------------------------------------------------------------------------------------------------------------------------------------------------------------------------------------------------------------------------------",
    "3": "------------------------------------------------TAAGCGGAGGAAAAGAAACCAACAGGGATTGCCCTAGTAACGGCGAGTGAAGCGGCAACAGCTCAAATTTGAAATCTGGCGC-----AAGCCCGAGTTGTAATTTGTAGAGGATGCTTCTGGGCAGC-GGCC-GGTCTAAGTTCCTTGGAACAGGACGTCACAGAGGGTGAGAATCCCGTATGTGATCGG--TTGGCACCCG-CTACGTAGCTCCTTCGACGAGTCGAGTTGTTTGGGAATGCAGCTCTAAATGGGAGGTAAATGCCTTCTAAAGCTAAATACCGGCCAGAGACCGATAGCGCACAAGTAGAGTGATCGAAAGATGAAAAGCACTTTGGAAAGAGAGTTAAAAAGCACGTGAAATTGTTGAAAGGGAAGCGCATGCAACCAGACTTGT-CCGCGGTGTTCCGCCGGTCTTCT-GACC-GGTCTAC-TCGCCGC-GGGCAGGCCAGCATCATCTGGGA-GCGCCGGATAAAGGTAGCGGGAATGTGGCCCC---TC-----GGGGTGTTATAGCTCGCTACACAATACGGCGCCTCCCGGGTGAGGTCCGCGCTTCGGCTAGGATGCTGGCGTAATGGTTGTATGCGG-CCCGTCTTGAAACACGGACCAAGGAGTCTACCATCTATGCGAGTGTTCGGGTGTCAAACCCCT-ACGCGCAATGAAAGTGAACGGAGG-TGGG-AACC-------GCAAGG-TGCACCATCGACCGATCCTGATGTC--TTCGGATGGATTTGAGTAAGAGCATAGCTGGTGGGACCCG-AAAGATGGTGAACTATG-CCTGAATA-GGGTGAAGCCAGAGGAAA-CT-CT-GGTGGAGGCTCGCAGCGG-TTCTGACGTGC-AAATC-GATCGTC-AAATTTGGGTATAGGGGCGAAAGACTAAT-CGAACCAT--------------------------------------------------------------------------------------------------------------------------------------------------------------------------------------------------------------------------------------------------------------------------------------------------------------------------",
    "4": "------------------------------------------------TAAGCGGAGGAAAAGAAACCAACAGGGATTGCCCTAGTAACGGCGAGTGAAGCGGCAACAGCTCAAATTTGAAATCTGGCGCCTTCGAAGCCCGAGTTGTAATTTGTAGAGGATGCTTCTGGGCAGC-GGCC-GGTCTAAGTTCCTTGGAACAGGACGTCACAGAGGGTGAGAATCCCGTATGTGATCGG-ATTGGCACCCG-CTACGTAGCTCCTTCGACGAGTCGAGTTGTTTGGGAATGCAGCTCTAAATGGGAGGTAAATGCCTTCTAAAGCTAAATACCGGCCAGAGACCGATAGCGCACAAGTAGAGTGATCGAAAGATGAAAAGCACTTTGGAAAGAGAGTTAAAAAGCACGTGAAATTGTTGAAAGGGAAGCGCATGCAACCAGACTTGT-CCGCGGTGTTCCGCCGGTCTTCT-GACC-GGTCTAC-TCGCCGC-GGGCAGGCCAGCATCATCTGGGA-GCGCCGGATAAAGGTAGCGGGAATGTGGCCCC--TTC----GGGGGTGTTATAGCTCGCTACACAATACGGCGCCTCCCGGGTGAGGTCCGCGCTTCGGCTAGGATGCTGGCGTAATGGTTGTATGCGG-CCCGTCTTGAAACACGGACCAAGGAGTCTACCATCTATGCGAGTGTTCGGGTGTCAAACCCCT-ACGCGCAATGAAAGTGAACGGAGG-TGGG-AACC-------GCAAGG-TGCACCATCGACCGATCCTGATGTC--TTCGGATGGATTTGAGTAAGAGCATAGCTGGTGGGACCCG-AAAGATGGTGAACTATG-CCTGAATA-GGGTGAAGCCAGAGGAAA-CT-CT-GGTGGAGGCTCGCAGCGG-TTCTGACGTGC-AAATC-GATCGTC-AAATTTGGGTATAGGGGCGAAAGACTAAT-CGAACCAT--------------------------------------------------------------------------------------------------------------------------------------------------------------------------------------------------------------------------------------------------------------------------------------------------------------------------",
    "5": "----------------------------------------------------CGGAGGAAAAGAAACCAACAGGGATTGCCCTAGTAACGGCGAGTGAAGCGGCAACAGCTCAAATTTGAAATCTGGCGCCTTCGAAGCCCGAGTTGTAATTTGTAGAGGATGCTTCTGGGCAGC-GGCC-GGTCTAAGTTCCTTGGAACAGGACGTCACAGAGGGTGAGAATCCCGTATGTGACCGG-ACTGGCACCCT-CCACGTAGCTCCTTCGACGAGTCGAGTTGTTTGGGAATGCAGCTCTAAATGGGAGGTAAATTCCTTCTAAAGCTAAATACCGGCCAGAGACCGATAGCGCACAAGTAGAGTGATCGAAAGATGAAAAGCACTTTGGAAAGAGAGTTAAAAAGCACGTGAAATTGTTGAAAGGGAAGCGCTTGCAACCAGACTTGT-TGGCGGTGTTCCGCCGGTCTTCT-GACC-GGTCTAC-TCGCCGT-CGGCAGGCCAGCATCATCTGGGG-CCGCCGGATAAAGGCGTGGGGAATGTGGCTCC-CTTC---GGGGAGTGTTATAGCCCCGCGTGCAATACGGCGTGTCCCGGGTGAGGTCCGCGCTTCGGCTAGGATGCTGGCGTAATGGTCGTAAGCGG-CCCGTCTTGAAACACGGACCAAGGAGTCTACCATCTATGCGAGTGTTCGGGTGTCAAACCCCT-ACGCGTAATGAAAGTGAACGGAGG-TGGG-AACC-------TCAAGG-TGCACCATCGACCGATCCTGATGTC--TTCGGATGGATTTGAGTAAGAGCATAGCTGGTGGGACCCG-AAAGATGGTGAACTATG-CCTGAATA-GGGTGAAGCCAGAGGAAA-CT-CT-GGTGGAGGCTCGCAGCGG-TTCTGACGTGC-AAATC-GATCGTC-AAATTTGGGTATAGGGGCGAAAGACTAAT-CGAACCAT--------------------------------------------------------------------------------------------------------------------------------------------------------------------------------------------------------------------------------------------------------------------------------------------------------------------------",
    "6": "------------------------------------------------TAAGCGGAGGAAAAGAAACCAACAGGGATTGCCCTAGTAACGGCGAGTGAAGCGGCAACAGCTCAAATTTGAAATCTGGCGCCTTCGAAGCCCGAGTTGTAATTTGTAGAGGATGCTTCTGGGCAGC-GGCC-GGTCTAAGTTCCTTGGAACAGGACGTCACAGAGGGTGAGAATCCCGTATGTGACCGG-ACTGGCACCCT-CCACGTAGCTCCTTCGACGAGTCGAGTTGTTTGGGAATGCAGCTCTAAATGGGAGGTAAATTCCTTCTAAAGCTAAATACCGGCCAGAGACCGATAGCGCACAAGTAGAGTGATCGAAAGATGAAAAGCACTTTGGAAAGAGAGTTAAAAAGCACGTGAAATTGTTGAAAGGGAAGCGCTTGCAACCAGACTTGT-TGGCGGTGTTCCGCCGGTCTTCT-GACC-GGTCTAC-TCGCCGT-CGGCAGGCCAGCATCATCTGGGG-CCGCCGGATAAAGGCGTGGGGAATGTGGCTCC-CTTC---GGGGAGTGTTATAGCCCCGCGTGCAATACGGCGTGTCCCGGGTGAGGTCCGCGCTTCGGCTAGGATGCTGGCGTAATGGTCGTAAGCGG-CCCGTCTTGAAACACGGACCAAGGAGTCTACCATCTATGCGAGTGTTCGGGTGTCAAACCCCT-ACGCGTAATGAAAGTGAACGGAGG-TGGG-AACC-------GCAAGG-TGCACCATCGACCGATCCTGATGTC--TTCGGATGGATTTGAGTAAGAGCATAGCTGGTGGGACCCG-AAAGATGGTGAACTATG-CCTGAATA-GGGTGAAGCCAGAGGAAA-CT-CT-GGTGGAGGCTCGCAGCGG-TTCTGACGTGC-AAATC-GATCGTC-AAATTTGGGTATAGGGGCGAAAGACTAAT-CGAACCAT--------------------------------------------------------------------------------------------------------------------------------------------------------------------------------------------------------------------------------------------------------------------------------------------------------------------------",
    "7": "------------------------------------------------TAAGCGGAGGAAAAGAAACCAACAGGGATTGCCCTAGTAACGGCGAGTGAAGCGGCAACAGCTCAAATTTGAAATCTGGCGC-----AAGCCCGAGTTGTAATTTGTAGAGGATGCTTCTGGGCAGC-GGCC-GGTCTAAGTTCCTTGGAACAGGACGTCACAGAGGGTGAGAATCCCGTATGTGATCGG--TTGGCACCCG-CTACGTAGCTCCTTCGACGAGTCGAGTTGTTTGGGAATGCAGCTCTAAATGGGAGGTAAATGCCTTCTAAAGCTAAATACCGGCCAGAGACCGATAGCGCACAAGTAGAGTGATCGAAAGATGAAAAGCACTTTGGAAAGAGAGTTAAAAAGCACGTGAAATTGTTGAAAGGGAAGCGCATGCAACCAGACTTGT-CCGCGGTGTTCCGCCGGTCTTCT-GACC-GGTCTAC-TCGCCGC-GGGCAGGCCAGCATCATCTGGGA-GCGCCGGATAAAGGTAGCGGGAATGTGGCCCC-CTTC---GGGGGGTGTTATAGCTCGCTACACAATACGGCGCCTCCCGGGTGAGGTCCGCGCTTCGGCTAGGATGCTGGCGTAATGGTTGTATGCGG-CCCGTCTTGAAACACGGACCAAGGAGTCTACCATCTATGCGAGTGTTCGGGTGTCAAACCCCT-ACGCGCAATGAAAGTGAACGGAGG-TGGG-AACC-------GCAAGG-TGCACCATCGACCGATCCTGATGTC--TTCGGATGGATTTGAGTAAGAGCATAGCTGGTGGGACCCG-AAAGATGGTGAACTATG-CCTGAATA-GGGTGAAGCCAGAGGAAA-CT-CT-GGTGGAGGCTCGCAGCGG-TTCTGACGTGC-AAATC-GATCGTC-AAATTTGGGTATAGGGGCGAAAGACTAAT-CGAACCAT--------------------------------------------------------------------------------------------------------------------------------------------------------------------------------------------------------------------------------------------------------------------------------------------------------------------------"
}