{
    "0": "-----------GGTTTAAACCCTTCCTATACTAATGAGCCCTACTACAACAATAATTTTAATCTCAAGCTTAGCAGCAGGCACTATTATTACCCTATCAAGCCACCATTGACTTCTAGCCTGAATCGGACTGGAAATCAACACCCTAGCCATCATCCCCATTATCTCCAAACTTCACCACCCACGATCAACAGAGGCTGCAACAAAATATTTCCTAACACAAGCAGCCGCCTCCGCCCTCATCCTATTTTCAAGCACAATTAACGCATGAGAAACAGGAACATGAAATATTTTATCAATTACCAACCCACAAGCCAACATTCTGCTAACCATAGCCCTAGCCATAAAACTAGGCCTGGCACCAACACACTTCTGACTCCCAGAAATCCTACAAGGCTCAACAATAAAAACAGCACTCATCATTAGCACCTGACAAAAACTGGCCCCCGCAGCCCTAATATACCTCACCATTAACAACTTATCACCAAAAATTTTATTAACAATAGGACTTCTATCAGCAACCATTGGGGGCTGGGGGGGCCTAAATCAAACACAGCTACGAAAAATCATAGCCTATTCATCAATCGCACACCTCGGCTGAATTGCAGCAATTGCCCCAATAATAACCAACATCATAACCCTAAACCTCATAATTTATATTATCATAACAACGTCAATATTTTTAGCACTAATCACAACCCAATCAAAAACCATTCAAGACACAACAACATCATGAACATCCTCCCCAGCCATCACTATTACCACCATACTAACCCTTTTATCCCTAGGAGGACTACCCCCCCTATCAGGATTTCTGCCAAAATGACTTATTCTAGAAGAATTAACAACACAAAACCTAACCCCAATAGCCACACTTTTAGCCATGGCCTCCCTACTTAGCCTCTTCTTCTACCTACGGCTAACCTACACTACAACACTAACACTGTCACCAAACACACCACCCACTAAACATAAATGACGGTTCAAACCCAAAATTCCAAACCTATTAACTATGATACTCCCAGCCTCAACTATAATCCTCCCCCTAACCCCAATAATATTACTTTAGAAACTTAGGATTAATCTAAAACCAAGGGCCTTCAAATCCCAAAACAGGAGTGAAAACCTCCTAGTTTCTG-C-TAAAACCTGTGGAACACTAGACCACATCTTCTGAATGCAACTCAGACACTTTAATTAAGCTAAGGCCTCCATGGATAGGAGGGCCTCGATCCCACAAAAACTTAGCTTGAAGAACCATCGTTGTAATTCAACTACAAAAAC-AATGACAATCACACGAAAATCCCACCCAATCTTCAAAATCGTAAACAACTCATTTATTGACCTACCAACCCCATCAAACATCTCAGCATGATGAAACTTCGGATCACTATTAGGAACATGTTTAATCCTACAAATCCTTACCGGACTATTCCTAGCCATGCACTACACAGCAGACATTTCATCAGCCTTCTCTTCAGTAGCTCACATCTGCCGAGATGTCCAATATGGCTGACTCATCCGCAATCTTCATGCTAACGGAGCTTCAATATTCTTTATCTGCATCTACCTCCACATTGGGCGCGGGCTCTACTACGGGTCCTTCATATTCAAAGAAACATGAAACCTTGGAGTCGTTTTACTTCTCCTCGTCATAGCGACTGCCTTCGTTGGCTACGTATTACCATGAGGACAAATATCATTCTGA",
    "1": "-----------GGTTTAAACCCTTCCTATACTAATGAGCCCTACTACAACAATAATTTTAATCTCAAGCTTAGCAGCAGGCACTATTATTACCCTATCAAGCCACCATTGACTTCTAGCCTGAATCGGACTGGAAATCAACACCCTAGCCATCATCCCCATTATCTCCAAACTTCACCACCCACGATCAACAGAGGCTGCAACAAAATATTTCCTAACACAAGCAGCCGCCTCCGCCCTCATCCTATTTTCAAGCACAATTAACGCATGAGAAACAGGAACATGAAATATTTTATCAATTACCAACCCACAAGCCAACATTCTGCTAACCATAGCCCTAGCCATAAAACTAGGCCTGGCACCAACACACTTCTGACTCCCAGAGATCCTACAAGGCTCAACAATAAAAACAGCACTCATCATTAGCACCTGACAAAAACTGGCCCCCGCAGCCCTAATATACCTCACCATTAACAACTTATCACCAAAAATTTTATTAACAATAGGACTTCTATCAACAACCATTGGGGGCTGGGGGGGCCTAAATCAAACACAGCTACGAAAAATCATAGCCTATTCATCAATCGCACACCTCGGCTGAATTGCAGCAATTGCCCCAATAATAACCAACATCATAACCCTAAACCTCATAATTTATATTATCATAACAACGTCAATATTTTTAGCACTAATCACAACCCAATCAAAAACCATTCAAGACACAACAACATCATGAACATCCTCCCCAGCCATCACTATTACCACCATACTAACCCTTTTATCCCTAGGAGGACTACCCCCCCTATCAGGATTTCTGCCAAAATGACTTATTCTAGAAGAATTAACAACACAAAACCTAACCCCAATAGCCACACTTTTAGCCATGGCCTCCCTACTTAGCCTCTTCTTCTACCTACGGCTAACCTACACTACAACACTAACACTGTCACCAAACACACCACCCACTAAACATAAATGACGGTTCAAACCCAAAATTCCAAACCTATTAACTATGATACTCCCAGCCTCAACTATAATCCTCCCCCTAACCCCAATAATATTACTTTAGAAACTTAGGATTAATCTAAAACCAAGGGCCTTCAAATCCCAAAACAGGAGTGAAAACCTCCTAGTTTCTG-C-TAAAACCTGTGGAACACTAGACCACATCTTCTGAATGCAACTCAGACACTTTAATTAAGCTAAGGCCTCCATGGATAGGAGGGCCTCGATCCCACAAAAACTTAGCTTGAAGAACCAYCGTTGTAATTCAACTACAAAAAC-AATGACAATCACACGAAAATCCCACCCAATCCTCAAAATCGTAAACAACTCATTTATTGACCTACCAACCCCATCAAACATCTCAGCATGATGAAACTTCGGATCACTATTAGGAACATGTTTAATCCTACAAATCCTTACCGGACTATTCCTAGCCATGCACTACACAGCAGACATTTCATCAGCCTTCTCTTCAGTAGCTCACATCTGCCGAGATGTCCAATATGGCTGACTCATCCGCAATCTTCATGCTAACGGAGCTTCAATATTCTTTATCTGCATCTACCTCCACATTGGGCGCGGGCTCTACTACGGATCCTTCATATTCAAAGAAACATGAAACCTTGGAGTCGTTTTACTTCTCCTCGTCATAGCGACTGCCTTTGTTGGCTACGTATTACCATGAGGACAAATATCATTCTGA",
    "2": "-----------GGTTTAAACCCTTCCTATACTAATGAGCCCTACTACAACAATAATTTTAATCTCAAGCCTAGCAGCAGGCACTATTATTACCCTATCAAGCCACCATTGACTTCTAGCCTGAATCGGACTGGAAATCAACACCCTAGCCATCATCCCCATTATCTCCAAACTTCACCACCCGCGATCAACAGAAGCTGCAACAAAATACTTCCTAACACAAGCAGCCGCCTCCGCCCTCATCCTATTTTCAAGCACAATTAACGCATGAGAAACAGGAACATGAAATATCTTATCAATTACCAATCCACAAGCCAACATTCTGCTAACCATAGCCCTAGCCATAAAACTAGGCCTAGCACCAACACACTTCTGACTCCCAGAAATCCTACAAGGCTCAACAATAAAAACAGCACTCATCATTAGCACCTGACAAAAGCTGGCCCCCGCAGCCCTAATATACCTCACCATTAACAGCCTATCACCAAAAATTTTATTAATAATAGGACTTCTATCAGCAACCATTGGGGGCTGGGGAGGCCTAAATCAAACACAACTACGAAAAATCATAGCCTACTCATCAATCGCACACCTCGGCTGAATTGCAGCAATTGCCCCAATAATAACCAACATCATAGCCCTAAACCTCACAATTTATATTATCATAACAACGTCAATATTTTTAGCACTAATCGCAACCCAATCAAAAACCATTCAAGACACAACAACATCATGAACATCCTCCCCAACCATCACTATTACCACCATATTAACCCTTTTATCCCTAGGAGGACTGCCCCCCCTATCAGGATTTATGCCAAAATGACTTATTCTAGAAGAATTAACAACACAAAACATAACCCCAATGGCCACACTTTTAGCCATGGCCTCCCTACTTAGCCTCTTCTTCTACTTACGACTAACCTACACTACAACATTAACATTGTCACCAAACACACCACCCACCAAACATAAATGACGATTCAAACCCAAAATTCCAAACCTATTAACTATAACACTCCCAGCCTCAACTATAATCCTCCCCCTAACCCCAATAATATTATTTTAGAAACTTAGGATTAATCCTAAACCAAGGGCCTTCAAATCCCAAAACAGGAGTGGAAACCTCCTAGTTTCTG-C-CAAAACCTGTGGAACACTAAACCACATCTTCTGAATGCAACTCAGACACTTTAATTAAGCTAAGGCCTCCCTAGATAGGAGGGCCTCGATCCCACAAAAACTTATCTTGAAAAACCACCGTTGTAATTCAACTACAAAAAC-AATGACAATCACACGAAAATCCCACCCAATTTTCAAAATCGTAAACAACTCATTTATTGATCTACCAACCCCATCCAACATCTCAGCATGATGAAACTTCGGATCACTATTAGGAACATGCTTAATCCTACAAATCCTTACCGGATTATTCTTAGCCATGCACTACACAGCAGACATTTCATCAGCCTTCTCTTCAGTGGCACACATCTGCCGAGATGTCCAATATGGCTGACTTATCCGCAATCTCCATGCTAATGGAGCTTCAATATTCTTTATTTGCATTTACCTCCACATTGGACGCGGACTTTACTACGGATCCTTCATATTCAAAGAAACATGAAACCTTGGAGTTGTCTTACTTCTCCTCGTCATAGCGACTGCCTTTGTTGGCTACGTACTGCCATGAGGACAAATATCATTCTGA",
    "3": "CCGAAAATGTTGGTTTAAACCCTTCCTATACTAATGAGCCCTACTACAACAATAATTTTAATCTCAAGCCTAGCAGCAGGCACTATTATTACCCTATCAAGCCACCATTGACTTCTAGCCTGAATCGGACTGGAAATCAACACCCTAGCCATCATCCCCATTATCTCCAAACTTCACCACCCGCGATCAACAGAAGCTGCAACAAAATATTTCCTAACACAAGCAGCCGCCTCCGCCCTCATCCTATTTTCAAGCACAATTAACGCATGAGAAACAGGAACATGAAATATCTTATCAATTACCAATCCACAAGCCAACATTCTGCTAACCATAGCCCTAGCCATAAAACTAGGCCTAGCACCAACACACTTCTGACTCCCAGAAATCCTACAAGGCTCAACAATAAAAACAGCACTCATCATTAGCACCTGACAAAAGCTGGCCCCCGCAGCCCTAATATACCTCACCATTAACAGCCTATCACCAAAAATTTTATTAATAATAGGACTTCTATCAGCAACCATTGGGGGCTGGGGAGGCCTAAATCAAACACAACTACGAAAAATCATAGCCTACTCATCAATCGCACACCTCGGCTGAATTGCAGCAATTGCCCCAATAATAACCAACATCATAGCCCTAAACCTCACAATTTATATTATCATAACAACGTCAATATTTTTAGCACTAATCGCAACCCAATCAAAAACCATTCAAGACACAACAACATCATGAACATCCTCCCCAACCATCACTATTACCACCATATTAACCCTTTTATCCCTAGGAGGACTGCCCCCCCTATCAGGATTTATGCCAAAATGACTTATTCTAGAAGAATTAACAACACAAAACATAACCCCAATGGCCACACTTTTAGCCATGGCCTCCCTACTTAGCCTCTTCTTCTACTTACGACTAACCTACACTACAACATTAACATTGTCACCAAACACACTACCCACCAAACATAAATGACGATTCAAACCCAAAATTCCAAACCTATTAACTATAACACTCCCAGCCTCAACTATAATCCTCCCCCTAACCCCAATAATATTATTTTAGAAACTTAGGATTAATCCTAAACCAAGGGCCTTCAAATCCCAAAACAGGAGTGGAAACCTCCTAGTTTCTG-C-CAAAACCTGTGGAACACTAAACCACATCTTCTGAATGCAACTCAGACACTTTAATTAAGCTAAGGCCTCCCTAGATAGGAGGGCCTCGATCCCACAAAAACTTAGCTTGAAGAACCATCGTTGTAATTCAACTACAAAAAC-AATGACAATCACACGAAAATCCCACCCAATTTTCAAAATCGTAAACAACTCATTTATTGATCTACCAACCCCATCCAACATCTCAGCATGATGAAACTTCGGATCACTATTAGGAACATGCTTAATCCTACAGATCCTTACCGGATTATTCTTAGCCATGCACTACACAGCAGACATTTCATCAGCCTTCTCTTCAGTGGCACACATCTGCCGAGATGTCCAATATGGCTGACTTATCCGCAATCTCCATGCTAATGGAGCTTCAATATTCTTTATTTGCATTTACCTCCACATTGGACGCGGACTTTACTACGGATCCTTCATATTCAAAGAAACATGAAACCTTGGAGTTGTCTTACTTCTCCTCGTTATAGCGACTGCCTTTGTTGGCTACGTACTGCCATGAGGACAAATATCATTCTGA",
    "4": "-----------GGTTTAAACCCTTCCTATACTAATGAGCCCTACTACAACAATAATTTTAATCTCAAGCTTAGCAGCAGGCACTATTATTACCCTATCAAGCCACCATTGACTTCTAGCCTGAATCGGACTGGAAATCAACACCCTAGCCATCATCCCCATTATCTCCAAACTTCACCACCCACGATCAACAGAGGCTGCAACAAAATATTTCCTAACACAAGCAGCCGCCTCCGCCCTCATCCTATTTTCAAGCACAATTAACGCATGAGAAACAGGAACATGAAATATTTTATCAATTACCAACCCACAAGCCAACATTCTGCTAACCATAGCCCTAGCCATAAAACTAGGCCTGGCACCAACACACTTCTGACTCCCAGAAATCCTACAAGGCTCAACAATAAAAACAGCACTCATCATTAGCACCTGACAAAAACTGGCCCCCGCAGCCCTAATATACCTCACCATTAACAACTTATCACCAAAAATTTTATTAACAATAGGACTTCTATCAGCAACCATTGGGGGCTGGGGGGGCCTAAATCAAACACAGCTACGAAAAATCATAGCCTATTCATCAATCGCACACCTCGGCTGAATTGCAGCAATTGCCCCAATAATAACCAACATCATAACCCTAAACCTCATAATTTATATTATCATAACAACGTCAATATTTTTAGCACTAATCACAACCCAATCAAAAACCATTCAAGACACAACAACATCATGAACATCCTCCCCAGCCATCACTATTACCACCATACTAACCCTTTTATCCCTAGGAGGACTACCCCCCCTATCAGGATTTCTGCCAAAATGACTTATTCTAGAAGAATTAACAACACAAAACCTAACCCCAATAGCCACACTTTTAGCCATGGCCTCCCTACTTAGCCTCTTCTTCTACCTACGGCTAACCTACACTACAACACTAACACTGTCACCAAACACACCACCCACTAAACATAAATGACGGTTCAAACCCAAAATTCCAAACCTATTAACTATGATACTCCCAGCCTCAACTATAATCCTCCCCCTAACCCCAATAATATTACTTTAGAAACTTAGGATTAATCTAAAACCAAGGGCCTTCAAATCCCAAAACAGGAGTGAAAACCTCCTAGTTTCTG-C-TAAAACCTGTGGAACACTAGACCACATCTTCTGAATGCAACTCAGACACTTTAATTAAGCTAAGGCCTCCATGGATAGGAGGGCCTCGATCCCACAAAAACTTAGCTTGAAGAACCATCGTTGTAATTCAACTACAAAAAC-AATGACAATCACACGAAAATCCCACCCAATCTTCAAAATCGTAAACAACTCATTTATTGACCTACCAACCCCATCAAACATCTCAGCATGATGAAACTTCGGATCACTATTAGGAACATGTTTAATCCTACAAATCCTTACCGGACTATTCCTAGCCATGCACTACACAGCAGACATTTCATCAGCCTTCTCTTCAGTAGCTCACATCTGCCGAGATGTCCAATATGGCTGACTCATCCGCAATCTTCATGCTAACGGAGCTTCAATATTCTTTATCTGCATCTACCTCCACATTGGGCGCGGGCTCTACTACGGATCCTTCATATTCAAAGAAACATGAAACCTTGGAGTCGTTTTACTTCTCCTCGTCATAGCGACTGCCTTTGTTGGCTACGTATTACCATGAGGACAAATATCATTCTGA",
    "5": "CCGAAAATGTTGGTTTAAACCCTTCCTATACTAATGAGCCCTACTACAACAATAATTTTAATCTCAAGCCTAGCAGCAGGCACTATTATTACCCTATCAAGCCACCATTGACTTCTAGCCTGAATCGGACTGGAAATCAACACCCTAGCCATCATCCCCATTATCTCCAAACTTCACCACCCGCGATCAACAGAAGCTGCAACAAAATATTTCCTAACACAAGCAGCCGCCTCCGCCCTCATCCTATTTTCAAGCACAATTAACGCATGAGAAACAGGAACATGAAATATCTTATCAATTACCAATCCACAAGCCAACATTCTGCTAACCATAGCCCTAGCCATAAAACTAGGCCTAGCACCAACACACTTCTGACTCCCAGAAATCCTACAAGGCTCAACAATAAAAACAGCACTCATCATTAGCACCTGACAAAAGCTGGCCCCCGCAGCCCTAATATACCTCACCATTAACAGCCTATCACCAAAAATTTTATTAATAATAGGACTTCTATCAGCAACCATTGGGGGCTGGGGAGGCCTAAATCAAACACAACTACGAAAAATCATAGCCTACTCATCAATCGCACACCTCGGCTGAATTGCAGCAATTGCCCCAATAATAACCAACATCATAGCCCTAAACCTCACAATTTATATTATCATAACAACGTCAATATTTTTAGCACTAATCGCAACCCAATCAAAAACCATTCAAGACACAACAACATCATGAACATCCTCCCCAACCATCACTATTACCACCATATTAACCCTTTTATCCCTAGGAGGACTGCCCCCCCTATCAGGATTTATGCCAAAATGACTTATTCTAGAAGAATTAACAACACAAAACATAACCCCAATGGCCACACTTTTAGCCATGGCCTCCCTACTTAGCCTCTTCTTCTACTTACGACTAACCTACACTACAACATTAACATTGTCACCAAACACACCACCCACCAAACATAAATGACGATTCAAACCCAAAATTCCAAACCTATTAACTATAACACTCCCAGCCTCAACTATAATCCTCCCCCTAACCCCAATAATATTATTTTAGAAACTTAGGATTAATCCTAAACCAAGGGCCTTCAAATCCCAAAACAGGAGTGGAAACCTCCTAGTTTCTG-C-CAAAACCTGTGGAACACTAAACCACATCTTCTGAATGCAACTCAGACACTTTAATTAAGCTAAGGCCTCCCTAGATAGGAGGGCCTCGATCCCACAAAAACTTAGCTTGAAGAACCATCGTTGTAATTCAACTACAAAAAC-AATGACAATCACACGAAAATCCCACCCAATTTTCAAAATCGTAAACAACTCATTTATTGATCTACCAACCCCATCCAACATCTCAGCATGATGAAACTTCGGATCACTATTAGGAACATGCTTAATCCTACAAATCCTTACCGGATTATTCTTAGCCATGCACTACACAGCAGACATTTCATCAGCCTTCTCTTCAGTGGCACACATCTGCCGAGATGTCCAATATGGCTGACTTATCCGCAATCTCCATGCTAATGGAGCTTCAATATTCTTTATTTGCATTTACCTCCACATTGGACGCGGACTTTACTACGGATCCTTCATATTCAAAGAAACATGAAACCTTGGAGTTGTCTTACTTCTCCTCGTCATAGCGACTGCCTTTGTTGGCTACGTACTGCCATGAGGACAAATATCATTCTGA",
    "6": "CCGAAAATGTTGGTTTAAACCCTTCCTATACTAATGAGCCCTACTACAACAATAATTTTAATCTCAAGCTTAGCAGCAGGCACTATTATTACCCTATCAAGCCACCATTGACTTCTAGCCTGAATCGGACTGGAAATCAACACCCTAGCCATCATCCCCATTATCTCCAAACTTCACCACCCACGATCAACAGAGGCTGCAACAAAATATTTCCTAACACAAGCAGCCGCCTCCGCCCTCATCCTATTTTCAAGCACAATTAACGCATGAGAAACAGGAACATGAAATATTTTATCAATTACCAACCCACAAGCCAACATTCTGCTAACCATAGCCCTAGCCATAAAACTAGGCCTGGCACCAACACACTTCTGACTCCCAGAAATCCTACAAGGCTCAACAATAAAAACAGCACTCATCATTAGCACCTGACAAAAACTGGCCCCCGCAGCCCTAATATACCTCACCATTAACAACTTATCACCAAAAATTTTATTAACAATAGGACTTCTATCAGCAACCATTGGGGGCTGGGGGGGCCTAAATCAAACACAGCTACGAAAAATCATAGCCTATTCATCAATCGCACACCTCGGCTGAATTGCAGCAATTGCCCCAATAATAACCAACATCATAACCCTAAACCTCATAATTTATATTATCATAACAACGTCAATATTTTTAGCACTAATCACAACCCAATCAAAAACCATTCAAGACACAACAACATCATGAACATCCTCCCCAGCCATCACTATTACCACCATACTAACCCTTTTATCCCTAGGAGGACTACCCCCCCTATCAGGATTTCTGCCAAAATGACTTATTCTAGAAGAATTAACAACACAAAACCTAACCCCAATAGCCACACTTTTAGCCATGGCCTCCCTACTTAGCCTCTTCTTCTACCTACGGCTAACCTACACTACAACACTAACACTGTCACCAAACACACCACCCACTAAACATAAATGACGGTTCAAACCCAAAATTCCAAACCTATTAACTATGATACTCCCAGCCTCAACTATAATCCTCCCCCTAACCCCAATAATATTACTTTAGAAACTTAGGATTAATCTAAAACCAAGGGCCTTCAAATCCCAAAACAGGAGTGAAAACCTCCTAGTTTCTG-C-TAAAACCTGTGGAACACTAGACCACATCTTCTGAATGCAACTCAGACACTTTAATTAAGCTAAGGCCTCCATGGATAGGAGGGCCTCGATCCCACAAAAACTTAGCTTGAAGAACCATCGTTGTAATTCAACTACAAAAAC-AATGACAATCACACGAAAATCCCACCCAATCTTCAAAATCGTAAACAACTCATTTATTGACCTACCAACCCCATCAAACATCTCAGCATGATGAAACTTCGGATCACTATTAGGAACATGTTTAATCCTACAAATCCTTACCGGACTATTCCTAGCCATGCACTACACAGCAGACATTTCATCAGCCTTCTCTTCAGTAGCTCACATCTGCCGAGATGTCCAATATGGCTGACTCATCCGCAATCTTCATGCTAACGGAGCTTCAATATTCTTTATCTGCATCTACCTCCACATTGGGCGCGGGCTCTACTACGGATCCTTCATATTCAAAGAAACATGAAACCTTGGAGTCGTTTTACTTCTCCTCGTCATAGCGACTGCCTTTGTTGGCTACGTATTACCATGAGGACAAATATCATTCTGA"
}