{
    "0": "ATGCCTAACCAACACACACTATTACTTTTCAACCTCCTTCCTGTAGGATTAAAAATCTCAACCTGATGAAACTTTGGATCAATACTACTTACCTGCTCAGCCCTACAAGTAATAACAGGGTTTTTCCTAGCCATTCACTACACAGCCAACATCAACCTAGCCTTCTCATCCATTGTCCACATCACACGTGACGTACCCTACGGATGAATTATACAAAACCTACATGCAATCGGAGCTTCCATATTCTTTATCTGCATCTACATTCATATCGCACGAGGACTATACTACGGATCATACCTAATCAAAAACGTATGGCTATCAGGAACAACCCTACTAATCATCCTCATAGCAACAGCCTTCTTTGGCTATGTGCTGCCATGAGGACAAATATCATTCTGAGCAGTAACAGTAATTACAAACCTATTAACTGCTGTACCATACATTGGCACAGCAATAACCACCTGACTCTGAGGTGGATTCTCAATCAACGACCCAACTCTAACCCGATTCTTCGCCCTCCATTTCATCCTTCCATTCGCTATTATTTCAATATCATCAATCCACATTATACTTCTCCACACAGAAGGATCCAGCAACCCATTAGGAACAAACTCAGATATCGATAAAATCCCATTCCACCCATATCACTCCCACAAAGACATCCTTATACTCACTATTATAATCACCACAATATTCACTATTATATCCTTCTCCCCGGACATCTTTAACGACCCTGAAAACTTCTCAAAAGCCAACCCCTTAGTAACACCTCAACACATTAAACCAGAATGATACTTTTTATTCGCCTACGGAATCCTTCGATCCATTCCAAACAAACTAGGAGGGACAGTAGCTCTAGTACTATCAGTAGCAATTCTTATAACAATACCATTCACCCACACCTCTTACATTCGATCCATAGCCTTTCGCCCAATCATA-AACTAGTATTTTGAACTCTAATTGCTACATTCATCACAATCACATGAGCAGCCACTAAACCGGTTGAACCACCATTTACAATCATTGGACAGACAACCTC-TTTCTATACTTTTCATTCTTCATCATAAACCCCCTAGTTGGCTGATTAGAAAACAAAATCTCATTCCATACATGCT",
    "1": "ATGCCTAACCAACACACACTATTACTTTTTAACCTCCTTCCTGTAGGATCAAACATCTCAACCTGATGAAACTTTGGATCAATACTACTAACCTGCTCAGCCCTACAAGTAATAACAGGGTTTTTCCTAGCCATTCACTACACAGCCAACATCAACCTAGCCTTCTCATCCATTGTCCACATCACACGTGACGTACCCTACGGATGAATTATACAAAACCTACATGCAATCGGAGCTTCCATATTCTTTATCTGCATCTACATTCATATCGCACGAGGACTATACTACGGATCATACCTAAACAAAAACGTATGGCTATCAGGAACAACCCTACTAATCATCCTCATAGCAACAGCCTTCTTTGGCTATGTGCTGCCATGAGGACAAATATCATTCTGAGCAGCAACAGTAATTACAAACCTATTAACTGCTGTACCATACATTGGCACAGCACTAACCACCTGACTCTGAGGTGGATTCTCAATCAACGACCCAACTCTAACCCGATTCTTCGCCCTCCATTTCATCCTTCCATTCGCTATTATTTCAATATCATCAATCCACATTATACTTCTCCACACAGAAGGATCCAGCAACCCATTAGGAACAAACTCAGATATCGATAAAATCCCATTCCACCCATATCACTCCCACAAAGACATCCTTATACTCACTATTATAATCACCACAATATTCACTATTATATCCTTCTCCCCGGACATCTTTAACGACCCTGAAAACTTCTCAAAAGCCAACCCCTTAGTAACACCTCAACACATTAAACCAGAATGATACTTTTTATTCGCCTACGGAATCCTTCGATCCATTCCAAACAAACTAGGAGGAACAGTAGCTCTAGTACTATCAGTAGCAATTCTTATAACAATACCATTCACCCACACCTCTTACATTCGATCCATAGCCTTTCGCCCAATCATACAACTAGTATTTTGAACTCTAATTGCTACATTCATCACAATCACATGAGCAGCCACTAAACCGGTTGAACCACCATTTACAATCATTGGACAGACAACCTCTTTTCTATACTTTTCATTCTTCATCATAAACCCCCTAGTTGGCTGATTAGAAAACAAAATCTCATTCCATACATGCT",
    "2": "-------------------TATTACTTTTCAACCTCCTTCCTGTAGGATCAAACATCTCAACCTGATGAAACTTTGGATCAATACTACTAACCTGCTCAGCCCTACAAGTAATAACAGGGTTTTTCCTAGCCATTCACTACACAGCCAACATTAACCTAGCCTTCTCATCCATTGTCCACATCACACGTGACGTACCCTACGGATGAATTATACAAAACCTACATGCAATCGGAGCTTCCATATTCTTTATCTGCATCTACATTCATATCGCACGAGGACTATACTACGGATCATACCTAAACAAAAACGTATGGCTATCAGGAACAACCCTACTAATCATCCTCATAGCAACAGCCTTCTTTGGCTATGTGCTGCCATGAGGACAAATATCATTCTGAGCAGCAACAGTAATTACAAACCTATTAACTGCTGTACCATACATTGGCACAGCACTAACCACCTGACTCTGAGGTGGATTCTCAATCAACGACCCAACTCTAACCCGATTCTTCGCCCTCCATTTCATCCTTCCATTCGCTATTATTTCAATATCATCAATCCACATTATACTTCTCCACACAGAAGGATCCAGCAACCCATTAGGAACAAACTCAGATATCGATAAAATCCCATTCCACCCATATCACTCCCACAAAGACATCCTCATACTCACTATTATAATCACCACAATATTCACTATTATATCCTTCTCCCCGGACATCTTTAACGACCCTGAAAACTTCTCAAAAGCCAACCCCTTAGTAACACCTCAACACATTAAACCAGAATGATACTTTTTATTCGCCTACGGAATCCTTCGATCCATTCCAAACAAACTAGGAGGGACAGTAGCTCTAGTACTATCAGTAGCAATTCTTATAACAATACCATTCACCCACACCTCTTACATTCGATCCATAGCCTTCCGCCCAATCATACAACTAGTATTTTGAACTCTAATTGCTACATTCATCACAATCACATGAGCAGCCACTAAACCGGTTGAACCACCATTTACAATCATTGGACAGACAACCTCTTTTCTATACTTTTCATTCTTCATCATAAACCCCCTAGTTGGCTGATTAGAAAACAAAATCTCATTCCATACATGCT",
    "3": "----------AACACACACTATTACTTTTTAACCTCCTTCCTGTAGGATCAAACATCTCAACCTGATGAAACTTTGGATCAATACTACTAACCTGCTCAGCCCTACAAGTAATAACAGGGTTTTTCCTAGCCATTCACTACACAGCCAACATCAACCTAGCCTTCTCATCCATTGTCCACATCACACGTGACGTACCCTACGGATGAATTATACAAAACCTACATGCAATCGGAGCTTCCATATTCTTTATCTGCATCTACATTCATATCGCACGAGGACTATACTACGGATCATACCTAAACAAAAACGTATGGCTATCAGGAACAACCCTACTAATCATCCTCATAGCAACAGCCTTCTTTGGCTATGTGCTGCCATGAGGACAAATATCATTCTGAGCAGCAACAGTAATTACAAACCTATTAACTGCTGTACCATACATTGGCACAGCACTAACCACCTGACTCTGAGGTGGATTCTCAATCAACGACCCAACTCTAACCCGATTCTTCGCCCTCCATTTCATCCTTCCATTCGCTATTATTTCAATATCATCAATCCACATTATACTTCTCCACACAGAAGGATCCAGCAACCCATTAGGAACAAACTCAGATATCGATAAAATCCCATTCCACCCATATCACTCCCACAAAGACATCTTAATACTCACTATTATAATCACCACAATATTCACTATTATATCCTTCTCCCCGGACATCTTTAACGACCCTGAAAACTTCTCAAAAGCCAACCCCTTAGTAACACCTCAACACATTAAACCAGAATGATACTTTTTATTCGCCTACGGAATCCTTCGATCCATTCCAAACAAACTAGGAGGGACAGTAGCTCTAGTACTATCAGTAGTAATTCTTATAACAATACCATTCACCCACACCTCTTACATTCGATCCATAGCCTTCCGCCCAATCATACAACTAGTATTTTGAACTCTAATTGCTACATTCATCACAATCACATGAGCAGCCACTAAACCAGTTGAACCACCATTTACAATCATTGGACAGACAACCTCTTTTCTATACTTTTCATTCTTCATCATAAACCCCCTAGTTGGCTGATTAGAAAACATAATC----------------",
    "4": "ATGCCTAACCAACACACACTATTACTTTTTAACCTCCTTCCTGTAGGATCAAACATCTCAACCTGATGAAACTTTGGATCAATACTACTAACCTGCTCAGCCCTACAAGTAATAACAGGGTTTTTCCTAGCCATTCACTACACAGCCAACATCAACCTAGCCTTCTCATCCATTGTCCACATCACACGTGACGTACCCTACGGATGAATTATACAAAACCTACATGCAATCGGAGCTTCCATATTCTTTATCTGCATCTACATTCATATCGCACGAGGACTATACTACGGATCATACCTAAACAAAAACGTATGGCTATCAGGAACAACCCTACTAATCATCCTCATAGCAACAGCCTTCTTTGGCTATGTGCTGCCATGAGGACAAATATCATTCTGAGCAGCAACAGTAATTACAAACCTATTAACTGCTGTACCATACATTGGCACAGCACTAACCACCTGACTCTGAGGTGGATTCTCAATCAACGACCCAACTCTAACCCGATTCTTCGCCCTCCATTTCATCCTTCCATTCGCTATTATTTCAATATCATCAATCCACATTATACTTCTCCACACAGAAGGATCCAGCAACCCATTAGGAACAAACTCAGATATCGATAAAATCCCATTCCACCCATATCACTCCCACAAAGACATCCTTATACTCACTATTATAATCACCACAATATTCACTATTATATCCTTCTCCCCGGACATCTTTAACGACCCTGAAAACTTCTCAAAAGCCAACCCCTTAGTAACACCTCAACACATTAAACCAGAATGATACTTTTTATTCGCCTACGGAATCCTTCGATCCATTCCAAACAAACTAGGAGGGACAGTAGCTCTAGTACTATCAGTAGCAATTCTTATAACAATACCATTCACCCACACCTCTTACATTCGATCCATAGCCTTCCGCCCAATCATACAACTAGTATTTTGAACTCTAATTGCTACATTCATCACAATCACATGAGCAGCCACTAAACCGGTTGAACCACCATTTACAATCATTGGACAGACAACCTCTTTTCTATACTTTTCATTCTTCATCATAAACCCCCTAGTTGGCTGATTAGAAAACAAAATCTCATTCCATACATGCT",
    "5": "ATGCCTAACCAACACACACTATTACTTTTTAACCTCCTTCCTGTAGGATCAAACATCTCAACCTGATGAAACTTTGGATCAATACTACTAACCTGCTCAGCCCTACAAGTAATAACAGGGTTTTTCCTAGCCATTCACTACACAGCCAACATCAACCTAGCCTTCTCATCCATTGTCCACATCACACGTGACGTACCCTACGGATGAATTATACAAAACCTACATGCAATCGGAGCTTCCATATTCTTTATCTGCATCTACATTCATATCGCACGAGGACTATACTACGGATCATACCTAAACAAAAACGTATGGCTATCAGGAACAACCCTACTAATCATCCTCATAGCAACAGCCTTCTTTGGCTATGTGCTGCCATGAGGACAAATATCATTCTGAGCAGCAACAGTAATTACAAACCTATTAACTGCTGTACCATACATTGGCACAGCACTAACCACCTGACTCTGAGGTGGATTCTCAATCAACGACCCAACTCTAACCCGATTCTTCGCCCTCCATTTCATCCTTCCATTCGCTATTATTTCAATATCATCAATCCACATTATACTTCTCCACACAGAAGGATCCAGCAACCCATTAGGAACAAACTCAGATATCGATAAAATCCCATTCCACCCATATCACTCCCACAAAGACATCCTTATACTCACTATTATAATCACCACAATATTCACTATTATATCCTTCTCCCCGGACATCTTTAACGACCCTGAAAACTTCTCAAAAGCCAACCCCTTAGTAACACCTCAACACATTAAACCAGAATGATACTTTTTATTCGCCTACGGAATCCTTCGATCCATTCCAAACAAACTAGGAGGGACAGTAGCTCTAGTACTATCAGTAGCAATTCTTATAACAATACCATTCACCCACACCTCTTACATTCGATCCATAGCCTTTCGCCCAATCATACAACTAGTATTTTGAACTCTAATTGCTACATTCATCACAATCACATGAGCAGCCACTAAACCGGTTGAACCACCATTTACAATCATTGGACAGACAACCTCTTTTCTATACTTTTCATTCTTCATCATAAACCCCCTAGTTGGCTGATTAGAAAACAAAATCTCATTCCATACATGCT",
    "6": "ATGCCTAACCAACACACACTATTACTTTTCAACCTCCTTCCTGTAGGATCAAACATCTCAACCTGATGAAACTTTGGATCAATACTACTAACCTGCTCAGCCCTACAAGTAATAACAGGGTTTTTCCTAGCCATTCACTACACAGCCAACATCAACCTAGCCTTCTCATCCATTGTCCACATCACACGTGACGTACCCTACGGATGAATTATACAAAACCTACATGCAATCGGAGCTTCCATATTCTTTATCTGCATCTACATTCATATCGCACGAGGACTATACTACGGATCATACCTAAACAAAAACGTATGGCTATCAGGAACAACCCTACTAATCATCCTCATAGCAACAGCCTTCTTTGGCTATGTGCTGCCATGAGGACAAATATCATTCTGAGCAGCAACAGTAATTACAAACCTATTAACTGCTGTACCATACATTGGCACAGCACTAACCACCTGACTCTGAGGTGGATTCTCAATCAACGACCCAACTCTAACCCGATTCTTCGCCCTCCATTTCATCCTTCCATTCGCTATTATTTCAATATCATCAATCCACATTATACTTCTCCACACAGAAGGATCCAGCAACCCATTAGGAACAAACTCAGATATCGATAAAATCCCATTCCACCCATATCACTCCCACAAAGACATCCTTATACTCACTATTATAATCACCACAATATTCACTATTATATCCTTCTCCCCGGACATCTTTAACGACCCTGAAAACTTCTCAAAAGCCAACCCCTTAGTAACACCTCAACACATTAAACCAGAATGATACTTTTTATTCGCCTACGGAATCCTTCGATCCATTCCAAACAAACTAGGAGGGACAGTAGCTCTAGTACTATCAGTAGCAATTCTTATAACAATACCATTCACCCACACCTCTTACATTCGATCCATAGCCTTTCGCCCAATCATACAACTAGTATTTTGAACTCTAATTGCTACATTCATCACAATCACATGAGCAGCCACTAAACCGGTTGAACCACCATTTACAATCATTGGACAGACAACCTCTTTTCTATACTTTTCATTCTTCATCATAAACCCCCTAGTTGGCTGATTAGAAAACAAAATCTCATTCCATACATGCT",
    "7": "ATGCCTAACCAACACACACTATTACTTTTCAACCTCCTTCCTGTAGGATCAAACATCTCAACCTGATGAAACTTTGGATCAATACTACTAACCTGCTCAGCCCTACAAGTAATAACAGGGTTTTTCCTAGCCATTCACTACACAGCCAACATCAACCTAGCCTTCTCATCCATTGTCCACATCACACGTGACGTACCCTACGGATGAATTATACAAAACCTACATGCAATCGGAGCTTCCATATTCTTTATCTGCATCTACATTCATATCGCACGAGGACTATACTACGGATCATACCTAAACAAAAACGTATGGCTATCAGGAACAACCCTACTAATCATCCTCATAGCAACAGCCTTCTTTGGCTATGTGCTGCCATGAGGACAAATATCATTCTGAGCAGCAACAGTAATTACAAACCTATTAACTGCTGTACCATACATTGGCACAGCACTAACCACCTGACTCTGAGGTGGATTCTCAATCAACGACCCAACTCTAACCCGATTCTTCGCCCTCCATTTCATCCTTCCATTCGCTATTATTTCAATATCATCAATCCACATTATACTTCTCCACACAGAAGGATCCAGCAACCCATTAGGAACAAACTCAGATATCGATAAAATCCCATTCCACCCATATCACTCCCACAAAGACATCCTTATACTCACTATTATAATCACCACAATATTCACTATTATATCCTTCTCCCCGGACATCTTTAACGACCCTGAAAACTTCTCAAAAGCCAACCCCTTAGTAACACCTCAACACATTAAACCAGAATGATACTTTTTATTCGCCTACGGAATCCTTCGATCCATTCCAAACAAACTAGGAGGGACAGTAGCTCTAGTACTATCAGTAGCAATTCTTATAACAATACCATTCACCCACACCTCTTACATTCGATCCATAGCCTTCCGCCCAATCATACAACTAGTATTTTGAACTCTAATTGCTACATTCATCACAATCACATGAGCAGCCACTAAACCGGTTGAACCACCATTTACAATCATTGGACAGACAACCTCTTTTCTATACTTTTCATTCTTCATCATAAACCCCCTAGTTGGCTGATTAGAAAACAAAATCTCATTCCATACATGCT"
}