{
    "0": "ATGAACCCCCTAATCTGAGCCATCCTAATCACCAGCCTCACAACAGGCACCATCATCACCATAGCCAGCCACCACTGACTGTTAGCCTGAATTGGCCTAGAACTAAACACCATAAGCATCCTACCCATCATCATACAACCAGCCCACCCACGATCAACCGAAGCAACAACAAAATACTTCCTAATCCAAGCCACTTCAGCAGCACTTATCCTATTTGCAAGCACCATAAACGCCTGACAAACAGGACACTGAACAATCTTACAATCCACCTCCCCCCTAACCACCACCATTGCCACAATAGCCATTATAATAAAACTGGCCATCGCCCCGGCACACCTATGATACCCAGAAATCCTCCAGGGCACCACCATAACCACAGCACTAATCATCTCCACATGACAAAAACTAGCCCCACTAGCAATGCTATA------AATGAGTCACCTGCCAACGCACACAATATTACTCCTAGGCCTACTCTCAGCCCTAATTGGCGGCTGATCCGGACTAAACCAAACCCAAACACGAAAAATAATAGCCTTTTCATCCATCGCACACATAGGCTGACTAATCACAGCCCTATGCTCAAACCCTAGTCTAACAACCCTAACTATACTAACCTATCTAACTATAACAACAACCATATTCCTTATACTACAAACCTCATCAACAAAATCATTAACTGACTCCGGCACAACATGAACCTACTCCCCACTCACACTGGCACTCACGATACTAACACTCCTCTCACTAGGGGGCCTCCCACCCTTAACCGGATTTATACCGAAACTACTAATCCTTAACGAACTTGCATCATCAAAACTCACACTCCTGGCCACCGCTCTAGCACTAGCCAGCCTTCCCAGCCTGGCCTTCTACACTCGAATAGCATACCTAACAACCCTAACAATCCCACCAAACACAACCTCCTCCGAATATAAATGACGATTTAAAACCCCCACCATCATGCTCAACTCAACCTTAATACTACTTACAACCCTAATCCTACCAATAACACCACTAATATATTACACAATA",
    "1": "ATGAGCCCCATAATCTGAGTAACCCTCATCACCAGCCTTGCAATAAGTACAATTATCATCATAACCAGCCACCACTGACTTCTCGCCTGACTTAGCTTAGAATTAAACACCTTAAGTATTCTACCAATCATTATACGCTCAAACCACCCACGAACAACCGAAGCAGCAACAAAATACTTCCTTATCCAAACCACAGCAGCCACACTAATCCTACTCGCAAGCACAATAAACGCCTGACAAACAGGCTCCTGAGACATCATACAATCCTTCTCCCCTTTCGCCACAGCCATCACCACCTTAGCTATCATAACAAAACTTGCCATTGCCCCAGCACACCTCTGATACCCAGAGATCCTCCAAGGCTCCACCATAACCACAGCACTAATTATCTCAACATGACAAAAAATTGCCCCACTAACCCTACTCTACCTATTAATTAACCACCTTTCAACAAACACCGTACTAATACTAGGCCTCACATCAGCCCTCATCGGAGGGTGAACTGGACTAAACCAAACCCAAACACGAAAAATCATAGCCTTCTCCTCCATCTCCCACATAGGATGACTAATCACAGCCTTATGCCTAAACCCTAGCCTGACTACACTAACCATAATCACCTATATAATTATAACAACAACAATATTCCTATCCCTAAATACATCCTCATCTAAAACACTACTAGACCTAGGAATCTCATGAACCCACTCACCAATCCTATTAACAGCCACAATATTAACCCTACTATCCCTAGCAGGGCTCCCACCCCTAACTGGTTTCATACCAAAACTGCTAATCCTAAAAGAACTTGTAACAATAAAATTACTACTCCTCAGCACAACACTAGCCCTAACTAGCCTCCCAAGCCTAGCCTTCTACACCCGCATAGCCTACCTAACAATTCTAACAACTCCCCCCAACACAACAAACTCAGAATACAAATGACGATTCAAAACCCCAATAACACCACTTACCCCCACAACAGCCCTACTAACAATACTGGCCTTACCAATAACTCCGCTACTATACCTGACCATT",
    "2": "ATGAGCCCCTTAATCTGAATAACACTTATCACAAGCCTTACAACAAGTACAATTATCATCATAACCAGCCACCACTGACTTCTCGCCTGACTAAGCCTAGAACTAAATACCTTAAGCATTCTACCTATTATTATACGCTCAAACCACCCACGAACAACTGAAGCAACAACAAAATACTTCCTTATTCAAACCACTGCAGCTGCACTAATTCTACTTGCAAGCACAATAAACGCCCGACAAACAGGCTCCTGAGACATCATACAATCCTTCTCCCCACTCGCTACCACCATCATCACTACAGCCGTCATAATAAAACTAGCCATCGCCCCAGCACACCTATGATACCCAGAAATCCTCCAAGGCACCACCATAACCACAGCACTAATTATCTCAACATGACAAAAAATCGCCCCCCTCACATTACTCTACCTACTAATCAACCACCTCTCAACAAATACTGTGTTACTACTAGGCCTTACATCAGCCCTTCTGGGGGGTTTAACCGGATTAAACCAAACCCAAACACGAAAAATCATAGCCTTCTCATCCATCTCCCACATGGGTTGACTAATTACAGCCCTATGCCTAAACCCTAGTCTATCTACTTTAACCATAATCACCTACATAGCCATGACAACAACAATATTCCTCTCCTTAGCCGCATCATCATCCAAAACACTACTGGACCTAGGAACCTCATGAACCCACTCACCCATCCTACTAACA-CTACAATATTAACCCTGCTCTCCCTCGCAGGACTGCCCCCTCTAACCGGCTTCATACCAAAACTACTAATCCTAAAAGAACTTGTAACAATAAAACTACTAGCCCTCACCACAATACTGGCCCTCACAAGCCTTCCAAGCTTAGCCTTCTACACCCGCATAGCCTACCTAACAACCCTAACAACTCCCCCTAACACAACAAACTCAGAGTACAAATGACGATTTAAAACCCCTATATCACCACTTATCCCAACAACAGCTCTACTCACAACATTAACCCTACCCATAACCCCACTACTATACCTTACCACC",
    "3": "ATGAGCCCCCTAATCTGAACAACCCTCATCACTAGCCTCACAATAAGCACAATTATCATCATAACCAGTAACCACTGACTTCTCGCTTGACTTAGCCTAGAACTAAACACCCTAAGCATTCTACCAATCATTATACGCTCAAACCACCCACGAACAACCGAAGCTGCAACAAAATACTTCCTTATCCAAACCACCGCAGCCACATTAATTTTACTCGCAAGCACAATAAACGCCTGACAAACAGGCTCCTGAGACATCATACAATCCTTCTCTCCTTTCGCCACAACCATCACCACCTTAGCTATTATAATAAAACTTGCCATTGCCCCAGCACACCTTTGATACCCAGAAATCCTCCAAGGCTCCACCATAACCACAGCACTAATCATCTCAACATGACAAAAAATCGCCCCACTAACACTGCTTTACCTATTAATTAACCATCTTTCAACAAACACCGTACTAATACTAGGCCTCACATCAGCCCTCATCGGAGGATGAACCGGACTAAACCAAACCCAAACACGAAAAATCATGGCCTTCTCCTCTATCTCCCACATAGGTTGACTAATTACGGCCTTATGCCTAAACCCCAGCCTGACTACACTAACTTTTATCACCTATATAATCATAACAACAACAATATTCCTCTCCCTAACTACATTTTCATCTAAAACACTACTAGACCTAGGAGTCTCATGAACCCACTCACCAATCCTGCTGACAATCACAATATTAACCCTACTCTCCCTAGCAGGCCTCCCACCCCTAACCGGCTTTATGCCAAAACTATTAATCCTAAAAGAACTTGTAACAATAAAACTACTGTTCCTCAGCACAACACTAGCCCTAACCAGCCTACCAAACTTAGCCTTCTACACCCGCATGGCTTACCTAACAACCCTAACAGCTCCACCCAACACAACAAACTCAGAATACAAATGACGATTCAAGACCCCAATAACACCACTTGCCCCCACAACAGCCTTACTAACAATACTAGCCCTACCAATAACCCCACTACTATACCTAGCCACT",
    "4": "ATGAGCCCCCTAATCTGAGCAACCCTCATCACCAGCCTCACAATAAGCACAATTATCATCATAACCAGCCACCACTGACTTCTCGCCTGACTTAGCCTAGAACTAAACACCCTAAGCATTCTACCAATCATTATACGCTCAAACCACCCACGAACAACCGAAGCAGCAACAAAATACTTCCTTATCCAAACCACTGCAGCCACACTAATCCTACTCGCAAGCACAATAAACGCCTGACAAACAGGCTCCTGAGACATCATACAATCCTTCTCCCCTTTCGCCACAACCATCACCACCTTAGCTATTATAATAAAACTTGCCATTGCCCCAGCACACCTATGATACCCAGAAATCCTCCAAGGCTCCACCATAACCACAGCACTAATCATCTCAACATGACAAAAAATCGCCCCACTAACACTGCTCTACCTATTAATTAACCACCTTTCAACAAACACCGTACTAATACTAGGCCTCACATCAGCCCTCATCGGAGGCTGAACCGGACTAAACCAAACCCAAACACGAAAAATCATAGCCTTCTCCTCCATCTCCCACATAGGCTGACTAATCACAGCCTTATGCCTAAACCCTAGCCTGACTACACTAACTATAATCACCTATATAATTATAACAACAACAATATTCCTCTCCCTAAATACATCCTCATCTAAAACACTACTAGACCTAGGAATCTCATGAACCCACTCACCAATCCTACTGACAATCACAATATTAACCCTACTCTCCCTAGCAGGCCTCCCACCCCTAACCGGCTTTATACCAAAACTACTAATCCTAAAAGAACTTGTAACAATAAAACTACTACTCCTCAGCACAACACTAGCCCTAACCAGCCTCCCAAGCCTAGCCTTCTACACCCGCATAGCCTACCTAACAACCCTAACAACTCCACCCAACACAACAAACTCAGAATACAAATGACGATTCAAAACCCCAATAACACCACTTACCCCCACAACAGCCCTACTAACAATACTAGCCCTACCAATAACCCCACTACTATACCTCACCATT",
    "5": "ATGAGCCCCCTAATCTGAGTAACCCTTATCACCAGCCTTACAACAAGTACAATTATCATCATAACCAGCCACCACTGACTTCTCGCCTGACTTAGCCTAGAACTAAACACCTTAAGCATTCTACCAATCATTATACGCTCAAACCACCCACGAACAACCGAAGCAACAACAAAATACTTCCTTATCCAAACCACTGCAGCCGCACTAATCCTACTTGCAAGCACAATAAACGCCTGACAAACAGGCTCCTGAGACATCATACAATCCTTCTCCCCACTCGCCACCACCATCACCACTATAGCCATCATAATAAAACTTGCCATCGCCCCAGCACACCTATGATACCCAGAAATCCTCCAAGGCACCACCATAACCACAGCACTAATTATCTCAACATGACAAAAAATCGCCCCACTAACACTACTCTACCTACTAATCAACCACCTCTCAACAAACACTGTATTACTACTAGGCCTCACATCAGCCCTCATCGGGGGCTGAACCGGACTAAACCAAACCCAAACACGAAAAATCATAGCCTTCTCATCCATCTCCCACATAGGCTGACTAATCACAGCCCTATGCCTAAACCCTAGTCTAACTACACTAACCATAATCACCTATATAACTATAACAACAACAATATTCCTCTCCCTAAACACATCATCATCCAAAACACTACTAGACCTAGGAACCTCATGAACCCACTCACCAATCCTACTAACAGCCACAATATTAACCCTACTCTCCCTAGCAGGACTCCCACCCCTAACCGGCTTCATACCAAAACTACTAATCCTAAAAGAACTTGTAACAATAAAACTACTACTCCTCACCACAACACTAGCCCTAACCAGCCTTCCAAGCCTAGCCTTCTACACCCGCATAGCCTACCTAACAACCCTAACAACTCCCCCCAACACAACAAACTCAGAATACAAATGACGATTTAAAACCCCCATAACACCACTTATCCCAACAACAGCCCTACTAACAACACTAACCCTACCAATAACCCCACTACTATACCTCACCATT",
    "6": "ATGAGCCCCCTAATCTGAATAACCCTCATCACCAGCCTTACAATAAGTACAATTATCATCATAACCAGCCACCACTGACTTCTCGCCTGACTTAGCCTAGAACTAAACACCTTAAGCATTCTACCAATCATTATACGCTCAAACCACCCACGAACAACCGAAGCAGCAACAAAATACTTCCTTATCCAAACCACTGCAGCCACACTAATTCTACTCGCAAGCACAATAAACGCCTGACAAACAGGCTCCTGAGACATCATACAATCCTTCTCCCCTTTCGCCACAACCATCACCACCTTAGCTATCATAATAAAACTTGCCATTGCCCCAGCACACCTATGATACCCAGAAATCCTCCAAGGCTCCACCATAACCACAGCACTAATTATCTCAACATGACAAAAAATCGCCCCACTAACACTACTCTACCTATTAATTAACCACCTTTCAACAAACACCGTACTAATACTAGGCCTCACATCAGCCCTCATCGGAGGATGAACCGGACTAAACCAAACCCAAACACGAAAAATCATAGCCTTCTCCTCCATCTCCCACATAGGTTGACTAATTACAGCCTTATGCCTAAACCCTAGCCTGACTACACTAACCATAATCACCTATATAATCATAACAACAACAATATTCCTCTCCCTAACTACATCCTCATCTAAAACACTACTAGACCTAGGAATCTCATGAACCCACTCACCAATCCTACTAACAACCACAATATTAACCCTACTCTCCCTAGCAGGACTCCCACCCCTAACCGGCTTCATACCAAAACTACTAATCCTAAAAGAACTTGTAACAATAAAACTACTAGTCCTCAGCACAACACTAGCCCTAACCAGCCTCCCAAGCTTAGCCTTCTACACCCGCATAGCCTACCTAACAACCCTAACAACTCCCCCCAACACAACAAACTCAGAATACAAATGACGATTCAAAACCCCAATAACACCACTTACCCCCACAACAGCCCTACTAACAATACTAGCCCTACCAATAACCCCACTACTATACCTAACCACT",
    "7": "ATGAGCCCCCTAATCTGAACAACCCTTATCACCAGCCTCACAACAAGCACAATTATCATCATAACCAGCCACCACTGACTTCTCGCCTGACTTAGCCTAGAACTAAACACCCTAAGCATTCTACCAATCATTATACGCTCAAACCACCCACGAACAACCGAAGCAACAACAAAATACTTCCTTATCCAAACCACTGCAGCCGCACTAATTCTACTTGCAAGCACAATAAACGCCTGACAAACAGGCTCCTGAGACATCATACAATCCTTCTCCCCACTCGCCACCACCATCACCACTATAGCCATTATAATAAAACTTGCCATCGCCCCAGCACACCTATGATACCCAGAAATCCTCCAAGGCACCACCATAACCACAGCACTAATCATCTCAACATGACAAAAAATCGCCCCACTAACACTGCTCTACCTACTAATCAACCACCTCTCAACAAACACTGTATTACTACTAGGCCTCACATCAGCCCTCATCGGGGGCTGAACCGGACTAAACCAAACCCAAACACGAAAAATCATAGCCTTCTCATCCATCTCCCACATAGGTTGACTAATTACAGCCCTATGCCTAAACCCTAGTCTAACTACACTAACTATAATCACCTATATAACCATAACAACAACAATATTCCTCTCCCTAACCACATCATCATCCAAAACACTACTAGACCTAGGAACCTCATGAACCCACTCACCAATCCTACTGACAATCACAATATTAACCCTACTCTCCCTAGCAGGCCTCCCACCCCTAACCGGCTTTATACCAAAACTACTAATCCTAAAAGAACTTGTAACAATAAAACTACTAGTCCTCACCACAACACTAGCCCTAACCAGCCTTCCAAGCTTAGCCTTCTACACCCGCATAGCCTACCTAACAACCCTAACAACTCCACCCAACACAACAAACTCAGAATACAAATGACGATTTAAAACCCCCATAACACCACTTATCCCAACAACAGCCCTACTAACAACACTAACCCTACCAATAACCCCACTACTATACCTCACCACT"
}