{
    "0": "ATGGAGGAATATCAAGTA---------TATTTAGAACTA---AATAGATCTCGCCATCAGGAC------TTCCTATATCCACTTATTTTTCGGGAGTATATTTATGGACTCACTTATGGTCATGATTTA------AATAGATCCATTTTTATAGAAAATGTGGGT------TATGACAAT------AAATCTAGTTTACTAATTGTAAAACGTTTAATTACTCGAATGTATCAACAAAGTCAATTGATCATTTCTACGAATGATTCTAACAAAAAT------CTATTTTGGGGGTATAACAATAATATTTATTCTCAAATAATATCAGAAGGTTTTGTTGTCGTCGTGGAAATTCCATTTTCCTTACAATTTAGCTCTTCC---------TTAGAAGGGGCAGAAATCGTAAAATTTTATAAAAATTTGCGATCAATTCATTCCATTTTTCCCTTTTTCGAGGATAAATTAATATATTTTAATTATGAGTCAGATATACGAATACCCTATCCTATCCATCTGGAAATCTTGGTTCAAATCCTTCGATACTGGATGAAAGATGTCTCTTTCTTTCATTTATTAAGGTTTTTTTTTTTT------TACTATTGTAATTGGAAT------------AGTCTTATTACTCCA------------AAAAAATTAATTTCTACTTTTTCA------AAAAGTAATCCAAGATTTTTCTTGTTTCTATATAATTTATATGTATGGGAACACGAATCTATCTTTCTTTTTCTACGGAACAAATCTTCTCATTTACGATTAGAATCTTTTTGCGTTTTTTTTGAACGAATTTTTTTCTATGCAAAAATAGAACAT------CTTGTACAAGTCATTGCT------AAGGATTTTTCATAT------ACTTTATCATTCTTCAAGGATCCTTTCATCCATTATGTTAGATATCAAGAAAAATCAATTCTGGTTTCAAGGAATACGCCTCTTTTGATGAATAAATGGAAATACTATTTTATCCATTTATGGCAATGTCATTTTGATGTTTGGTCTCAACCAGGAACGATCCATATAAACCAATTA---TCCGAGCATTCA---------TTTCACTTTTTG------GATTATTTTTTAAATTTGCAACTAAATCTTTCAGTGGTACGGAGTCAAATGTTGCAAAATTCATTTCTAATGGAAATTGTTATGAAAAAGCTTGATACAAGAGTTCCAATTATTCTTCTAATTAGATCATTGGTTAAAGCGAAATTTTGTAATGTATTGGGGCATCCCCTTAGTAAGTCGGTCTGGGCCGATTTATCCGATTTTGATATTATTGACCGATTTTTGCGGATATGCAGAAATTTTTCTCATTATTACAATGGATCCTCAAAAAAAAAGAATTTGTATCGAATAAAATATATACTTCGGCTTTCTTGTATTAAAACTTTGGCTCGTAAACACAAAAGTACTGTACGCGCTTTTTTGAAAAGATTAGATTCAGAAAAATTATTGGAAGAATTCTTT---ACAGAAGAAGAAGACATTTTTTCTTTGATCTTTCCA------AGAACTTCTTCTACTTTGCAG------AGGTTATATAGAGGTCGAATTTGGTATTTGGATATTCTTTTC---AGCCATGATCCTGATCTAGTCAAC---CATTCATAA---AAAAAAAAAACAAAAAAAAAAAAAACAAAAAACAAAA",
    "1": "ATGGAGGAATTTCAAGTA---------TATTTAGAACTA---GATAGATCTCGTCAACATGAC------TTCCTATACCCACTTATTTTTCGGGAGTATATTTATGCACTTGCTTACGATCATGGTTTA------AATAGTTCCATTTTGGTGCAAAATCTAGGT------TATGACAAT------AAATCTAGTTTACTAATTGTAAAACGTTTAATTACTCGAATGTATCAACAGAATCATTTGATTATTTCTGCTAATAATTCTAACAAAAAT------CCATTTTTGGGGTACAACAAGAATTTGTATTCTCAAATAATATCAGAGGGGCTTGCCGTCAGTGTGGAAATTCCATTTTCCCTACAATTAATATCTTCC---------TTAGAGAAGGCAGAAATCATAAAATCCTAT---AATTTACGATCAATTCATTCGATATTTCCTTTTTTTGAGGAAAAATTTCCATATTTAAATTATGTGTCAGATGTACAAATACCCTACCCTATCCATCTGGAAATCTTGATTCAAACCCTTCGATACTGGGAGAAAGATGCCTCCTCCTTTCATTTATTAAGGCTCTTTCTTTAT------GAGTATTGTAATTGGAAT------------AGTCTTATTACTCCA------------AAAAACAGGATTTCTACTTTTTCA------AAAAGTAATCCAAGATTTTTCCTGTTCCTATATAATTTTTATGTATGTGAATACGAATCCATCTTTCTTTTTCTCCGTAACAAATCTTCTTATTTACGATTAACATCTTCTGGAGTTTTTTTTGAACGAATCTATTTCTATGCAAAAATAGAACAT------TTTGTAGAAGTCTTTGAA------AAGGATTTTCCGTCC------ACCCTACGGTTCTTCAAGGACCCTTTCATTCATTATGTTAGATATCAAGGAAAATCCATTCTGGCTTCAAAGAATACGCCCTTTTTGATGAAAAAATGGAAATACTATCTTATCCATTTATGGCAATGTCATTTTTTTGTTTGGTCTCAACCAGGAAAGATCCATATAAACCAATTA---TCCGAGCATTCA---------TTTTCCTTTTTG------GGCTATTTTTCAAATGTGCGGCTAAATCCTTCAGTGGTACGGAGTCAAATGTTGGAAAAGTCATTTATAATGGAAAATCTTATGAAAAAGCTTGATACAATAATTCCAATTGTTCCTCTAATTAGATCATTGGCTAAAGCAAGATTTTGTAATCTATTAGGACATCCCATTAGTAAGCCGGTCTGGGCCGATTCATCCGATTTTGATATTATTGAACGATTTTTGCAGATATGCAGAGATCTTTCTCATTATTACAACGGGTCCTCAAAAAAAAAGAGTTTGTATCGAATCAAATATATACTTCGGCTTTCTTGTATTAAAACTTTGGCGCGTAAACACAAAAGCACTGTACGGGTTTTTTTGAAAAGATTAGGTTCTGAA---TTATTGCAAGAATTCTTT---ACAGAGGAAGAAGATATTTTTTCTTTGATCTTCTCA------AGAGCTTCTTCTACTTTGCAG------AAGTTATATACAGATCGGATTTGGTATTTGGATATTTTTGATTTT---------------------------CATCAATGA---AAAAAAAAAAAAAAAAAAAAAAAAAAAAAACCAGAAA",
    "2": "ATGGAGGAATTTCAAGTA---------TATTTAGAACTA---GATAGATCTCGTCAACATGAC------TTCCTATACCCACTTATTTTTCGGGAGTATATTTATGCACTTGCTTACGATCATGGTTTA------AATAGTTCCATTTTGGTGCAAAATCTAGGT------TATGACAAT------AAATCTAGTTTACTAATTGTAAAACGTTTAATTACTCGAATGTATCAACAGAATCATTTGATTATTTCTGCTAATAATTCTAACAAAAAT------CCATTTTGGGGGTACAACAAGAATTTGTATTCTCAAATAATATCAGAGGGGCTTGCCGTCAGTGTGGAAATTCCATTTTCCCTACAATTAATCTCTTCC---------TTAGAGAAGGCAGAAATAATCAAATCCTAT---AATTTACGATCAATTCATTCAATATTTCCTTTTTTTGAGGAAAAATTTCCATATTTAAATTATGTGTCAGATGTACAAATACCCTACCCTATCCATCTGGAAATCTTGATTCAAACCCTTCGATACTGGGTGAAAGATGCCTCCTCCTTTCATTTATTAAGGCTCTTTCTTTAT------GAGTATTGTAATTGGAAT------------AGTCTTATTACTCCA------------AAAAAAAGGATTTCTACTTTTTCAAATTCAAAAAGGAATCCAAGATTTTTCCTGTTCCTATATAATTTTTATGTATGTGAATACGAATCCATCTTTCTTTTTCTCCGTACCAAATCTTCTTATTTACGATTAACATCTTTTGGAATCCTTTTTGAGCGAATTTATTTCTATGCAAAAATAGAACAT------TTTGTAGAAGTCTTTGAT------AAGGATTTTCCGTCC------ACCCTATGGTTCTTCAAGGACCCTTTCATTCATTATGTTAGATATCAAGGAAAATCCATTCTGGCTTCAAAGAATACGCCCTTTTTGATGAAAAAATGGAAATACTTTCTTATCCATTTATGGCAATGTCATTTTTTTGTTTGGTCTCAACCAGGAAAGATCCATATAAACCAATTA---TCCGAGCATTCA---------TTTTACTTTTTG------GGCTATTTTTCAAATGTGCGGCTAAATCCTTCAGTGGTACGGAGTCAAATGTTGGAAAAGTCATTTATAATGGAAAATCTTATGAAAAAGCTTGATACAATAATTCCAATTATTCCTCTAATTAGATCATTGGCTAAAGCAAAATTTTGTAATGTATTAGGATATCCCATTAGTAAGCCGGTCTGGGCCGATTCATCCGATTTTTATATTATTGACCGATTTTTGCAGATATGCAGAGATCTTTCCCATTATTACAACGGATCCTCAAAAAAAAAGAGTTTGTATCGAATCAAATATATACTTCGGCTTTCTTGTATTAAAACTTTGGCGCGTAAACACAAAAGTACTGTACGGTTTTTTTTGAAAAGATTAGGTTCTGAA---TTATTGGAAGAATTCTTT---ACAGAGGAAGAAGAGATTTTTTCTTTGATCTTCTCA------AGAGCTTCTTCTACTTTGCAG------AAGTTAGATAGAGGTCGGATTTGGTATTTGGATATTTTTGATTTT---------------------------CATCAATGA---AAAAAAAAAAAAAAAAGAAAAAAAAAAAAACCAGAAA",
    "3": "ATGGAGGAATTTCAAGTA---------TATTTAGAACTA---GATAGATCTCGTCAACATGAC------TTCCTATACCCACTTATTTTTCGGGAGTATATTTTTGCACTTGCTTACGATCATGGTTTA------AATAGTTCCATTTTGGTGCAAAATCTAGGT------TATGACAAT------AAATCTAGTTTACTAATTGTAAAACGTTTAATTACTCGAATGTATCACCAGAATCATTTGATTATTTCTGCTAATAATTCTAACAAAAAC------CCATTTTGGGGGTACAACAAGAATTTGTATTCTCAAATAATATCAGAGGGGCTTGCCGTCAGTGTGGAAATTCCATTTTCCCTACAATTAATCTCTTCC---------TTAGAGAAGGCAGAAATTATAAAATCCTAT---AATTTACGATCAATTCATTCAATATTTCCTTTTTTTGAGGAAAAATTTCCATATTTAAATTATGTGTCAGATGTACAAATACCCTACCCTATACATCTGGAAATCTTGATTCAAACCCTTCGATACTGGGTGAAAGATGCCTCCTCCTTTCATTTATTAAGGCTCTTTCTTTAT------GAGTATTGTAATTGGAAT------------AGTCTTATTACTCCA------------AAAAAAAGGATTTCTACTTTTTCA------AAAAGTAATCCAAGATTTTTCCTGTTCCTATATAATTTTTATGTATGTGAATACGAATCCATCTTTCTTTTTCTCCGTAACAAATCTTCTTATTTACGATTAACATCTTCTGGAGTCTTTTTTGAACGAATCTATTTCTATGCAAAAATAGAACAT------TTTGTAGAAGTCTTTGAT------AAGGATTTTCCGTCC------ACCCTATGGTTCTTCAAGGACCCTTTCATTCATTATGTTAGATATCAAGGAAAATCCATTCTAGCTTCAAAGAATACGCCCTTTTTGATGAAAAAATGGAAATACTATCTTATCCATTTATGGCAATGTCATTTTTTTGTTTGGTCTCAACCAGGAAAGATTCATATAAACCAATTA---TCCGAGCATTCA---------TTTTACTTTTTG------GGTTATTTTTCAAATGTGCGGCTAAATCCTTCAGTGGTACGGAGTCAAATGTTGGAAAAGTCATTTATAATGGAAAATCTTATGAAAAAGCTTGATACAATAATTCCAATTATTCCTCTAATTAGATCATTGGCTAAAGCAAATTTTTGTAATGTATTAGGACATCCCATTAGTAAGCCGGTCTGGGCCGATTCATCCGATTTTGATATTATTGAGCGATTTTTGCAGATATGCAGAGATCTCTCTCATTATTACAACGGATCCTCAAAAAAAAAGAGTTTGTATAGAATCAAATATATACTTCGGCTTTCTTGTATTAAAACTTTGGCGCGTAAACACAAAAGTACTGTACGGGTTTTTTTGAAAAGATTAGGTTCTGAA---TTATTAGAAGAATTCTTT---ACAGAGGAAGAAGATATTTTTTCTTTGATCTTCTCA------AGAGCTTCTTCTACTTTGCAG------AAGTTATATAGAGGTCGGATTTGGTATTTTGATATTTTTGATTTT---------------------------CATCAATGA---AAAAAAAAAAAAAAAAAAAAAAAAAAAAAACCAGAAA",
    "4": "ATGGAGGAATTTCAAGTA---------TATTTAGAACTA---GATAGATCTCGTCAACATGAC------TTCCTATACCCACTTATTTTTCGGGAGTATATTTATGCACTTGCTTACGATCATGGTTTA------AATAGTTCCATTTTGGTGCAAAATCTAGGT------TATGACAAT------AAATCTAGTTTACTAATTGTAAAACGTTTAATTACTCGAATGTATCAACAGAATCATTTGATTATTTCTGCTAATAATTCTAACAAAAAT------CCATTTTGGGGGTACAACAAGAATTTGTATTCTCAAATAATATCAGAGGGGCTTGCCGTCAGTGTGGAAATTCCATTTTCCCTACAATTAATCTCTTCC---------TTAGAGAAGGCAGAAATCATAAAATCCTATAAAAATTTACGATCAATTCATTCAATATTTCCTTTTTTTGAGGAAAAATTTCCATATTTAAATTATGTGTCAGATGTACAAATACCCTACCCTATCCATCTGGAAATCTTGATTCAAACCCTTCGATACTGGGTGAAAGATGCCTCCTCCTTTCATTTATTAAGGCTCTTTCTTTAT------GAGTATTGTAATTGGAAT------------AGTCTTATTACTCCA------------AAAAAAAGGATTTCTACTTTTTCAAATTCAAAAAGTAATCCAAGATTTTTCCTGTTCCTATATAATTTTTATGTATGTGAATACGAATCCATCTTTCTTTTTCTCCGTAACAAATCTTCTTATTTACGATTAACATCTTTTGGAGTCTTTTTTGAACGAATTTATTTCTATGCAAAAATAGAACAT------TTTGTAGAAGTCTTTGAT------AAGGATTTTCCGTCC------ACCCTATGGTTCTTCAAGGACCCTTTCATTCATTATGTTAGATATCAAGGAAAATCCATTCTGGCTTCAAAGAATACGCCCTTTTTGATGAAAAAATGGAAATACTATCTTATCCATTTATGGCAATGTCATTTTTTTGTTTGGTCTCAACCAGGAAAGATCCATATAAACCAATTA---TCCGAGCATTCA---------TTTTACTTTTTG------GGTTATTTTTCAAATGTGCGGCTAAATCCTTCAGTGGTACGGAGTCAAATGTTGGAAAAGTCATTTATAATGGAAAATCTTATGAAAAAGCTTGATACAATAATTCCAATTATTCCTCTAATTAGATCATTGGCTAAAGCAAAATTTTGTAATGTATTAGGACATCCCATTAGTAAGCCGGTCTGGGCCGATTCATCCGATTTTGATATTATTGACCGATTTTTGCAGATATGCAGAGATCTTTCTCATTATTACAACGGATCCTCAAAAAAAAAGAGTTTGTATCGAATCAAATATATACTTCGGCTTTCTTGTATTAAAACTTTGGCGCGTAAACACAAAAGTACTGTACGGGTTTTTTTGAAAAGATTAGGTTCTGAAAAATTATTGGAAGAATTCTTT---ACAGAGGAAGAAGAGATTTTTTCTTTGATCTTCTCA------AGAGCTTCTTCTACTTTGCAG------AAGTTATATAGAGGTCGGATTTGGTATTTGGATATTTTTGATTTTAGCCATGATCCTGATCTAGTCAAC---CATCAATGA---AAAAAAAAAAAAAAAAAAAAAAAAAAAAAACCAGAAA",
    "5": "ATGGAGGAATTTCAAGTA---------TATTTAGAACTA---GATAGATCTCGTCAACATGAC------TTCCTATACCCACTTATTTTTCGGGAGTATATTTATGCACTTGCTTACGATCATGGTTTA------AATAGTTCCATTTTGGTGCAAAATCTAGGT------TATGACAAT------AAATCTAGTTTACTAATTGTAAAACGTTTAATTACTCGAATGTATCAACAGAATCATTTGATTATTTCTGCTAATAATTCTAACAAAAAT------CCATTTTGGGGGTACAACAAGAATTTGTATTCTCAAATAATATCAGAGGGGCTTGCCGTCAGTGTGGAAATTCCATTTTCCCTACAATTAATCTCTTCC---------TTAGAGAAGGCAGAAATCATAAAATCCTAT---AATTTACGATCAATTCATTCAATATTTCCTTTTTTTGAGGAAAAATTTCCATATTTAAATTATGTGTCAGATGTACAAATACCCTACCCTATCCATCTGGAAATCTTGATTCAAACCCTTCGATACTGGGTGAAAGATGCCTCCTCCTTTCATTTATTAAGGCTCTTTCTTTAT------GAGTATTGTAATTGGAAT------------AGTCTTATTACTCCA------------AAAAAAAGGATTTCTACTTTTTCAAATTCAAAAAGTAATCCAAGATTTTTCCTGTTCCTATATAATTTTTATGTATGTGAATACGAATCCATCTTTCTTTTTCTCCGTAACAAATCTTCTTATTTACGATTAACATCTTCTGGAGTCTTTTTTGAACGAATCTATTTCTATGCAAAAATAGAACAT------TTTGTAGAAGTCTTTGAT------AAGGATTTTCCGTCC------ACCCTATGGTTCTTCAAGGACCCTTTCATTCATTATGTTAGATATCAAGGAAAATCCATTCTGGCTTCAAAGAATACGCCCTTTTTGATGAAAAAATGGAAATACTATCTTATCCATTTATGGCAATGTCATTTTTTTGTTTGGTCTCAACCAGGAAAGATCCATATAAACCAATTA---TCCGAGCATTCA---------TTTTACTTTTTG------GGCTATTTTTCAAATGTGCGGCTAAATCCTTCAGTGGTACGGAGTCAAATGTTGGAAAAGTCATTTATAATGGAAAATCTTATGAAAAAGCTTGATACAATAATTCCAATTATTCCTCTAATTAGATCATTGGCTAAAGCAAAATTTTGTAATGTATTAGGACATCCCATTAGTAAGCCGGTCTGGGCCGATTCATCCGATTTTGATATTATTGACCGATTTTTGCAGATATGCAGAGATCTTTCTCATTATTACAACGGATCCTCAAAAAAAAAGAGTTTGTATCGAATCAAATATATACTTCGGCTTTCTTGTATTAAAACTTTGGCGCGTAAACACAAAAGTACTGTACGGGTTTTTTTGAAAAGATTAGGTTCTGAA---TTATTGGAAGAATTCTTT---ACAGAGGAAGAAGATATTTTTTCTTTGATCTTCTCA------AGAGCTTCTTCTACTTTGCAG------AAGTTATATAGAGGTCGGATTTGGTATTTGGATATTTTTGATTTT---------------------------CATCAATGA---AAAAAAAAAAAAAAAAAAAAAAAAAAAAAACCAGAAA",
    "6": "ATGGAGGAATTTCAAGTA---------TATTTAGAACTA---GATAGATCTCGTCAACATGAC------TTCCTATACCCACTTATTTTTCGGGAGTATATTTATGCACTTGCTTACGATCATGGTTTA------AATAGTTCCATTTTGGTGCAAAATCTAGGT------TATGACAAT------AAATCTAGTTTACTAATTGTAAAACGTTTAATTACTCGAATGTATCAACAGAATCATTTGATTATTTCTGCTAATAATTCTAACAAAAAT------CCATTTTGGGGGTACAACAAGAATTTGTATTCTCAAATAATATCAGAGGGGCTTGCCGTCAGTGTGGAAATTCCATTTTCCCTACAATTAATCTCTTCC---------TTAGAGAAGGCAGAAATCATAAAATCCTATAAAAATTTACGATCAATTCATTCCATATTTCCTTTTTTTGAGGAAAAATTTCCATATTTAAATTATGTGTCAGATGTACAAATACCCTACCCTATCCATCTGGAAATCTTGATTCAAACCCTTCGATACTGGGTGAAAGATGCCTCCTCCTTTCATTTATTAAGGCTCTTTCTTTAT------GAGTATTGTAATTGGAAT------------AGTCTTATTACTCCA------------AAAAAAAGGATTTCTACTTTTTCAAATTCAAAAAGTAATCCAAGATTTTTCCTGTTCCTATATAATTTTTATGTATGTGAATACGAATCCATCTTTCTTTTTCTCCGTAACAAATCTTCTTATTTACGATTAACATCTTTTGGAGTTTTTTTTGAACGAATTTATTTCTATGCAAAAATAGAACAT------TTTGTAGAAGTCTTTGAT------AAGGATTTTCCGTCC------ACCCTATGGTTCTTCAAGGACCCTTTCATTCATTATGTTAGATATCAAGGAAAATCCATTCTGGCTTCAAAGAATACGCCCTTTTTGATGAAAAAATGGAAATACTATCTTATCCATTTATGGCAATGTCATTTTTTTGTTTGGTCTCAACCAGGAAAGATCCATATAAACCAATTA---TCCGAGCATTCA---------TTTTACTTTTTG------GGCTATTTTTCAAATGTGCGGCTAAATCCTTCAGTGGTACGGAGTCAAATGTTGGAAAAGTCATTTATAATGGAAAATCTTATGAAAAAGCTTGATACAATAATTCCAATTATTCCTCTAATTAGATCATTGGCTAAAGCAAAATTTTGTAATGTATTAGGACATCCCATTAGTAAGCCGGTCTGGGCCGATTCATCCGATTTTGATATTATTGACCGATTTTTGCAGATATGCAGAGATCTTTCTCATTATTACAACGGATCCTCAAAAAAAAAGAGTTTGTATCGAATCAAATATATACTTCGGCTTTCTTGTATTAAAACTTTGGCGCGTAAACACAAAAGTACTGTACGGGTTTTTTTGAAAAGATTAGGTTCTGAAAAATTATTGGAAGAATTCTTT---ACAGAGGAAGAAGAGATTTTTTCTTTGATCTTCTCA------AGAGCTTCTTCTACTTTGCAG------AAGTTATATAGAGGTCGGATTTGGTATTTGGATATTTTTGATTTTAGCCATGATCCTGATCTAGTCAAC---CATCAATGA---AAAAAAAAAAAAAAAAAAAAAAAAAAAAAACCAGAAA",
    "7": "ATGGAGGAATTTCAAGTA---------TATTTAGAACTA---GATAGATCTCGTCAACATGAC------TTCCTATACCCACTTATTTTTCGGGAGTATATTTATGCACTTGCTTACGATCATGGTTTA------AATAGTTCCATTTTGGTGCAAAATCTAGGT------TATGACAAT------AAATCTAGTTTACTAATTGTAAAACGTTTAATTACTCGAATGTATCAACAGAATCATTTGATTATTTCTGCTAATAATTCTAACAAAAAT------CCATTTTGGGGGTACAACAAGAATTTGTATTCTCAAATAATATCAGAGGGGCTTGCCGTCAGTGTGGAAATTCCATTTTCCCTACAATTAATCTCTTCC---------TTAGAGAAGGCAGAAATCATAAAATCCTATAAAAATTTACGATCAATTCATTCCATATTTCCTTTTTTTGAGGAAAAATTTCCATATTTAAATTATGTGTCAGATGTACAAATACCCTACCCTATCCATCTGGAAATCTTGATTCAAACCCTTCGATACTGGGTGAAAGATGCCTCCTCCTTTCATTTATTAAGGCTCTTTCTTTAT------GAGTATTGTAATTGGAAT------------AGTCTTATTACTCCA------------AAAAAAAGGATTTCTACTTTTTCA------AAAAGTAATCCAAGATTTTTCCTGTTCCTATATAATTTTTATGTATGTGAATACGAATCCATCTTTCTTTTTCTCCGTAACAAATCTTCTTATTTACGATTAACATCTTCTGGAGTTTTTTTTGAACGAATCTATTTCTATGCAAAAATAGAACAT------TTTGTAGAAGTCTTTGAT------AAGGATTTTCCGTCC------ACCCTATGGTTCTTCAAGGACCCTTTCATTCATTATGTTAGATATCAAGGAAAATCCATTCTGGCTTCAAAGAATACGCCCTTTTTGATGAAAAAATGGAAATACTATCTTATCCATTTATGGCAATGTCATTTTTTTGTTTGGTCTCAACCAGGAAAGATCCATATAAACCAATTA---TCCGAGCATTCA---------TTTTACTTTTTG------GGTTATTTTTCAAATGTGCGGCTAAATCCTTCAGTGGTACGGAGTCAAATGTTGGAAAAGTCATTTATAATGGAAAATCTTATGAAAAAGCTTGATACAATAATTCCAATTATTCCTCTAATTAGATCATTGGCTAAAGCAAAATTTTGTAATGTATTAGGACATCCCATTAGTAAGCCGGTCTGGGCCGATTCATCCGATTTTGATATTATTGACCGATTTTTGCAGATATGCAGAGATCTTTCTCATTATTACAACGGATCCTCAAAAAAAAAGAGTTTGTATCGAATCAAATATATACTTCGGCTTTCTTGTATTAAAACTTTGGCGCGTAAACACAAAAGTACTGTACGGGTTTTTTTGAAAAGATTAGGTTCTGAAAAATTATTGGAAGAATTCTTT---ACAGAGGAAGAAGATATTTTTTCTTTGATCTTCTCA------AGAGCTTCTTCTACTTTGCAG------AAGTTATATAGAGGTCGGATTTGGTATTTGGATATTTTTGATTTTAGCCATGATCCTGATCTAGTCAAC---CATCAATGA---AAAAAAAAAAAAAAAAAAAAAAAAAAAAAACCAGAAA"
}